TTTTRTTTRTTTTVTTTTTTRTTTTVTTTTTT
TTPTTTTRDTTMMMMMMMMTTTTDTTTTRTTT
TTTRTTTRVTTTTVTTTTRTRTTTTTTTTTTT
MMMMMMMMVTTTTDTTTTTTRTTTDTTTRTTT
TTRTTTTRTTTTTTTTRTTTTTTTTTTTTTTT
TTTTDTTTVVTTTTTTTTTMMMMMMMTTTTTT
TTTTTTRTTTTVTTDTTTTTTVTTTRTTTTTT
TTTTTTTTTTTTTTTTTTTTTTTTTTTTTTTT